+---------------------------------------------------------+
|                         |                         |     |
|  ---------------  |  ----     ----  ------------  |---  |
|    |        |     |  |        |  |             |  |     |
|-----  ----  |  ---|  |  -------  ------------  |  |     |
|       |  |  |  |  |  |  |           |  |       |     |  |
|  ------     |  |     |  ----  ----  |  |  -----------|  |
|     |          |     |  |     |        |  |          |  |
|  |  ------------------     |  |---------  |  ------  |  |
|  |        |                |  |           |       |  |  |
|  |        |  -----------------|  ---------------  |  |  |
|  ------        |              |        |       |  |     |
|    |  |--------|  ---------   |  ----  |  ---  ---------|
|--     |        |  |     |     |  |     |    |           |
|       |     |  |  |---  |  -------  |  |    |---------  |
|--------  ----  |  |     |     |     |  ---  |  |        |
|    |     |     |  |     |     |     |    |  |  |  ------|
|       ----  ----  |   ------     -----|  |  |  |  |     |
|       |           |        |     |    |  |  |     |     |
|  ---  |------  -------  |  |  ----  ------  |  ---|  ---| 
|  |    |     |  |     |  |  |  |     |       |     |     |
|  |  ---  |  |  |     ---|  |  |  ----  ---------  |---  |
|  |  |    |  |  |  |     |  |  |        |       |  |     |
|  |---  ---  |  |  ----  |  |  ---------|  |  --|  |  ---|
|  |     |    |  |     |  |  |     |     |  |    |  |     |
|     |---  ---  |  ----  |  |  ----  |  |  ---  |  |  |  |
|  ----  |  |    |  |     |     |     |  |    |  |  |  |  |
|     |  |  ------  |  ----------  ----  ---  |  |  |  |  |
|---     |    |     |        |     |       |  |  |  |  |  |
|        |    |  ----------  |  ----   -----  |  |  ----  |
|        |                |        |          |           |
+---------------------------------------------------------+ 