++++++++++++++++++++++++++++++++++++++++
+--------+++++++----------++++----+----+
+--------------------------------------+
+--+--+----++----++++++++++-------+++--+
+--+--+--------------------------------+
+--+--+---+++++++++++----++---++++++---+
+--+--+--------------------------------+
+--+--+-----++-------+++------+--------+
+--+---+--------+++-----------+-+++----+
+-----------+--+---+----------+--------+
+---+++-----------------+++---+-----+--+
+-+----+-+--------------------+----+---+
+-+----+-+------++++++--------+----+---+
+-+----+-+---------------++---+--------+
+-+----+-+--------------------------+--+
+-+----+-+++++++++++++-----++-------+--+
+-------------------------------+++----+
+---++---+++++++++++++-----------------+
++----------------------+++-----+------+
++++++++++++++++++++++++++++++++++++++++