+---------------------------------------------+
|                      |                      |
|     ----  ---------  |  ------------  ----  |
|  |     |       |  |  |           |    |  |  |
|  |  |  |  ---  |  -------  |  |  |  ---  |  |
|  |  |  |  |    |           |  |  |  |    |  |
|  |  |  |  |  ---------------  ------|  --|  |
|  |  |  |  |                   |  |  |    |  |
|  |  |  |  |  ------------------  |  ---  |  |
|  |  ----  |   |                  |       |  | 
|  |     |  ----|  -----------  ----  ------  |      
|  |     |                   |        |       | 
|  ----  ------------------  |---------  -----|
|     |             |     |  |                |
|  |  |  ---------        |  |  ------------  |
|  |  |    |     |     |  |  |             |  |
|  ---------  |  -------  ---------------  |  |
|             |        |  |             |  |  |
|--------------  ----------  ---------  |  |  |
|                |           |          |  |  |
|  ------------  |  -------  |    ------------|
|    |  |     |  |        |  |        |       |
|-----     |  |  -------  |  |  ----          |
|          |              |  |  |             |
+---------------------------------------------+ 